7 5
0 0 0 1 1 1
1 0 0 1 0 1
2 0 0 1 0 1
3 0 0 1 0 1
4 0 0 1 0 1
5 0 0 1 0 1
6 0 1 1 0 0
0 1 1 1 1 1
1 1 1 1 1 1
2 1 1 1 1 1
3 1 1 1 1 1
4 1 1 1 1 1
5 1 1 1 1 1
6 1 1 0 1 0
0 2 1 1 1 1
1 2 1 1 1 1
2 2 1 1 1 1
3 2 1 1 1 1
4 2 1 1 1 1
5 2 1 1 1 1
6 2 1 0 1 0
0 3 1 1 1 1
1 3 1 1 1 1
2 3 1 1 1 1
3 3 1 1 1 1
4 3 1 1 1 1
5 3 1 1 1 1
6 3 1 0 1 0
0 4 1 1 1 1
1 4 1 1 1 1
2 4 1 1 1 1
3 4 1 1 1 1
4 4 1 1 1 1
5 4 1 1 1 1
6 4 1 0 1 1
START
1
0 0 u
GOAL
4
6 4 u
6 4 l
6 4 d
6 4 r
4